0 1 1 1 1 1 2 24 24 24 24 24 24 24 24 0 1 1 1 1 2 24 24 
0 32 33 33 33 34 2 24 24 24 24 24 24 24 24 8 32 33 33 34 10 24 24
0 40 41 41 41 42 1 1 1 1 1 1 2 24 24 8 40 41 41 42 10 24 24
0 40 41 43 41 58 33 33 33 33 33 34 10 24 24 8 40 41 41 42 10 24 24
0 40 41 41 41 41 41 41 41 41 41 42 1 1 1 1 40 41 41 42 10 24 24
16 17 17 17 17 17 40 41 41 41 41 58 33 33 33 33 59 41 41 42 10 24 24
24 24 24 24 24 8 40 41 41 41 41 56 17 17 17 17 57 41 41 42 10 24 24
24 24 24 24 24 8 40 41 41 41 41 42 10 24 24 8 40 41 41 42 10 24 24
24 24 24 24 24 16 17 17 17 41 17 17 18 24 24 8 48 49 49 50 10 24 24
24 24 24 24 24 24 24 24 8 35 10 24 24 24 24 16 17 17 17 17 18 24 24
24 24 24 24 24 24 24 24 8 35 10 24 24 24 24 24 24 24 24 24 24 24 24
24 24 24 24 24 24 24 24 8 35 10 24 24 24 24 24 24 24 24 24 24 24 24
24 24 24 24 24 24 24 0 1 35 1 2 24 24 24 24 24 24 24 24 24 24 24
24 24 24 24 24 24 24 0 32 41 34 2 24 24 24 24 24 24 24 24 24 24 24
24 24 24 0 1 1 1 19  40 41 42 19 1 1 1 2 24 24 24 24 24 24
24 24 24 24 8 46 58 33 33 59 41 58 33 33 59 44 10 24 24 24 24 24 24
24 24 24 24 8 46 41 41 41 41 41 41 41 41 41 44 10 24 24 24 24 24 24
24 24 24 24 8 62 37 37 37 37 37 37 37 37 37 63 10 24 24 24 24 24 24
24 24 24 24 8 45 45 45 45 45 45 45 45 45 45 45 10 24 24 24 24 24 24
24 24 24 24 16 17 17 17 17 17 17 17 17 17 17 17 18 24 24 24 24 24 24